1111111111111111111111111111111111
1E000000S000000C00000C000000000001
101001010010E000101001000000010101
101001001010101000100100E000010101
1P0000000C00C000S000000000000000C1
1111111111111111111111111111111111
